g,g,g,g,g,g,g,g,g,g,g,g,g,g,g,g
g,a,a,a,a,a,a,a,a,a,a,a,a,a,a,g
g,a,a,a,a,a,a,a,a,a,a,a,a,a,a,g
g,g,g,a,a,a,a,g,g,a,a,a,a,a,a,g
g,a,g,g,a,a,a,a,a,a,a,a,g,g,a,g
g,a,a,g,g,a,a,a,a,a,a,g,g,a,a,g
g,a,a,a,a,a,a,a,a,a,a,a,a,a,a,g
g,a,a,a,a,g,g,g,g,g,g,a,a,a,a,g
g,a,a,a,a,a,a,a,g,a,a,a,a,a,a,g
g,a,g,g,a,a,a,a,a,a,a,a,a,a,a,g
g,a,a,a,a,a,a,g,a,a,a,a,a,a,a,g
g,a,a,a,a,g,a,a,a,a,a,a,g,g,a,g
g,a,a,g,g,a,a,g,a,a,a,a,a,a,a,g  
g,a,a,a,a,a,a,a,a,a,g,g,g,a,a,g   
g,a,a,a,a,a,a,a,a,g,g,g,a,a,a,g
g,g,g,g,g,g,g,g,g,g,g,g,g,g,g,g